{
	"mapTitle":"Goblin Den (Level 1)",
	"width":41,
	"height":23,
	"backgroundTile":"floor64",
	"enableLight":true,
	"mapData0":[
		"░░░░░░░░░░░░░░░░░░░░░░░░░░░░░░░░░░░░░░░░░",
		"░░░░░░░░░█ █░░░░░░░░░░░░░░░░░░░░░░░░░░░░░",
		"░░███████   ████████░░░████████████████░░",
		"░█                  █░█                █░",
		"░                    ░                  ░",
		"░                    ░    i       i     ░",
		"░                    ░                  ░",
		"░░ i              i ░░░░░░░░░░ ░░░░░░░░░░",
		"░█                  █░░███████ ████████░░",
		"░                    ░█                █░",
		"░                    ░                  ░",
		"░                    ░                  ░",
		"░                    █                  ░",
		"░                                       ░",
		"░                    ░     i     i      ░",
		"░                    ░                  ░",
		"░                    ░░░░░░░░░ ░░░░░░░░░░",
		"░░                  ░░░███████ ████████░░",
		"░█ i              i █░█                █░",
		"░                    ░                  ░",
		"░░░░░░░░░░   ░░░░░░░░░░░░░░░░   ░░░░░░░░░",
		"░░░░░░░░░░░ ░░░░░░░░░░░░░░░░░░ ░░░░░░░░░░",
		"░░░░░░░░░░░░░░░░░░░░░░░░░░░░░░░░░░░░░░░░░"
	],
	"objects":[
		{"id":"teleport", "x":11,"y":21, "target":"0001", "tx":3, "ty":1}
	],
	"monsters":[
		{"id":"Goblin", "x":7, "y":12},
		{"id":"Goblin", "x":15, "y":16},
		{"id":"Goblin", "x":32, "y":12},
		{"id":"Goblin", "x":27, "y":12},
		{"id":"Goblin", "x":32, "y":4},
		{"id":"GoblinCaptain", "x":27, "y":4},
		{"id":"GoblinArcher", "x":11, "y":20}
	]
}